P P P P P P P F F F F F F F F F F F F F F F F F F F F P P C C C
P P P P P P P P B F F F F F F F F F F F F F F F F P P P P P C C
P P P P O O P P B B F F F F F F F F F F F F F F F F F P P P P C
P P P P F F O P P P P P F F F F F F F F F F F F F F P P P P P C
P P P F F F F O P P P P P F F F F F F P P P P P P P P P P B B P
P P F F F F F F O P P G P F F F F F P P P P P L P P P P P B P P
P P F F F F F F O P P P P F F F F F P P P P P P P P P P P P P P
P F F F F F F P O P P P F F F F F F P P P P P P P P P P P P P P
P P F F G F P P P O P P F F F F P P P P P P P P P P P P P P P P
P P F F P P P L P P O P P F F P P P P P P P P P P P P P P P P P
P P P P P P P P P P P P P P P P P P P P P P P P P P P P P P P P
P P P P P P P P P P P P P P P P P P P P P P P O O P P P P P P P
P P P P P P P P P P P P P P P P P P P P P O O R R O O O G P P P
C P P P P P P P P P P P P P P P P P P P P R R R R R C C O O P P
C C C P P P P P P P P P P P P P P P P P R R R R R R R C P P P P
C C P P P P P P P P P P P P P P P P P P R R R R R R R C C P P P
C P P P P P P P B B B F P P P P P P P P P R R R R R R C P P P P
C P P P P G F F F F F F F P P O P P P P P P R R R R G P P P P P
P P P P P F F F F F F F F F O P P P P P P P R R P P P P P P P P
P P P P P F F F F F O O O O P P P P P P P R R P P P P P P P P P
P P P P F F F F F O P L P P P P P P P P P R R P P P P P P M P P
P P P P B B F O O P P P P P P P P P P P R R B B P P A P M M M P
P P P P P B P P P P P P P P P P P P R R R R B P P A A P M M M M
P P P P P P P P P P P P P P P R G R R R R R C P A A P M M M M M
P P P P P P P P P P P P P P R R R R R R R C C C C C C P P M M M